19 21
1 0
17 20
#####################
                  ###
### ############# ###
#   #           # ###
# # # ####### # # ###
# # # #     # # # ###
# # # # ### # # # ###
# # # # # # # # # ###
# # # # # # # # # ###
# #   # # # #   # ###
# ##### # ##### # ###
#       #       # ###
### ########### # ###
#             # # ###
##### ####### # # ###
#       #   # # # ###
# ##### ### # # # ###
#     #     #   #
#####################
