14 16
2 0
12 15
################
#            ###
  ## ## # ######
# ## ####      #
# ## # ##  # # #
# ## # ##  # # #
# #### ##  # # #
#       #  # # #
# ##### #### # #
# ## ##    # # #
# ## ##### # # #
# ## #   # #####
#      # #
################
